1 1 1 1 1 1 1 1 1 1 1 1 1 1 1 1 1 1 1 1 1 1 1 1 1 1 1 1 1 1 1 1 1 1 1 1 1 1 1 1 1 1 1 1 1 1 1 1 1 1
1                                                                                                 1
1                                                                                                 1
1                                                                                                 1
1                                                                                                 1
1                                                                                                 1
1                                                                                                 1
1                                                                                                 1
1                                 1 1 1 1 1 1 1 1 1 1 1 1 1 1 1 1 1 1 1 1                         1
1                                 1                                     1                         1
1                                 1                                     1                         1
1                                 1                                     1                         1
1                                 1                                     1                         1
1                                 1                                     1                         1
1                                                                       1 1 1 1                   1
1                                 1                                     1     1                   1
1                                 1                                     1     1                   1
1                 1 1 1 1 1 1 1 1 1 1 1 1 1 1 1                         1     1                   1
1                 1                           1                   1 1   1     1 1 1 1 1 1 1 1 1   1
1                 1                           1                         1     1               1   1
1                 1                           1                         1     1               1   1
1                 1                           1                         1     1               1   1
1                 1                           1                         1     1               1   1
1                 1                           1                         1     1               1   1
1                 1                           1                         1     1               1   1
1                 1                           1                         1     1               1   1
1                 1                           1 1 1 1 1 1 1 1 1 1 1 1 1 1     1               1   1
1                 1                           1     1           1             1               1   1
1                 1                       1   1     1           1                             1   1
1                 1                           1     1           1             1               1   1
1                 1           1               1     1           1 1 1 1 1 1 1 1               1   1
1                 1         1 1               1     1                                         1   1
1                 1                           1     1                                         1   1
1                 1                           1     1                                         1   1
1                                             1     1                                         1   1
1                 1                           1     1                                         1   1
1                 1                           1     1                                         1   1
1                 1                           1     1                                         1   1
1                 1                           1                                               1   1
1                 1                           1     1                                         1   1
1                 1                           1     1                                         1   1
1                 1 1 1 1 1 1 1 1 1 1 1 1 1 1 1     1                                         1   1
1                                                   1 1 1 1 1 1 1 1 1 1 1 1 1 1 1 1 1 1 1 1 1 1   1
1                                                                                                 1
1                                                                                                 1
1                                                                                                 1
1                                                                                                 1
1                                                                                                 1
1                                                                                                 1
1 1 1 1 1 1 1 1 1 1 1 1 1 1 1 1 1 1 1 1 1 1 1 1 1 1 1 1 1 1 1 1 1 1 1 1 1 1 1 1 1 1 1 1 1 1 1 1 1 1
seed: 69744398204635
5,0
nrooms: 5
4,0
4,-1
4,-2
4,-3
nrooms: 4
3,0
3,-1
nrooms: 3
2,0
2,-1
2,-2
2,-3
2,-4
2,-5
2,-6
2,-7
2,-8
2,-9
nrooms: 2
1,0
1,-1
1,-2
1,-3
1,-4
1,-5
1,-6
1,-7
1,-8
1,-9
1,-10
1,-11
1,-12
1,-13
1,-14
1,-15
nrooms: 1
